R 1920 1080

NO ./assets/images/face_north.xpm
SO ./assets/images/face_south.xpm
WE ./assets/images/face_west.xpm
EA ./assets/images/face_east.xpm

V ./assets/images/viseur.xpm

S ./assets/images/baril.xpm

F ./assets/images/vitrail-3.xpm
C ./assets/images/ice.xpm

111111111111111111111111111111
110000000000000000000000000011
100000000000000000000000000001
100000000000000000000000000001
100000000000000000000000000001
100000000000020000000000000001
100000000000000000000000000001
100000000000000000000000000001
1000000000000N0000000000000001
100000000000000000000000000001
100000000000000000000000000001
100000000000000000000000000001
100000000000000000000000000001
100000000000000000000000000001
100000000000000000000000000001
100000000000000000000000000001
100000000000000000000000000001
110101010101010101010101010101
111111111111111111111111111111