R 1200 600

NO ./assets/images/face_north.xpm  
SO ./assets/images/face_south.xpm
WE ./assets/images/face_west.xpm  
EA ./assets/images/face_east.xpm  
 
V ./assets/images/viseur.xpm  

S ./assets/images/baril.xpm
   
F ./assets/images/vitrail-3.xpm
C ./assets/images/ice.xpm

        1111111111111111111111111
        1000000000110000000000001
        101100000111000000200001
        1001000000000000000000011
111111111011111111110000000000001
100000000011     1110111110111111
111101111111  1  100000010001   1
11110111 11111211101010010001   1
11000000110101011100000010001   1
100020001000000000000000000021  1
10000000S00000001101010010022111
11000001010101011111011110022121
111101100011010101011110100010001
111110000011111111111111101110001
1000000001        112000000000001
111111111          11111111111111