R 320 200
11111
11011
10001
10N01
10001
11011
11111
