R 320 200
1 1 1 1 1
1 0 0 0 1
1 0 0 0 1
1 N 0 0 1
1 0 0 0 1
1 1 1 1 1