R 1320 1200
111111
110111
110011
10N001
110011
110101
111111
