R 1000 600

NO ./assets/images/solv2.xpm
SO ./assets/images/floor.xpm
WE ./assets/images/bricks64.xpm
EA ./assets/images/banana.xpm

V ./assets/images/viseur.xpm

S ./assets/images/tux.xpm
S3 ./assets/images/baril.xpm
S4 ./assets/images/clown.xpm

F ./assets/images/shinning.xpm
C ./assets/images/beton.xpm

11111111111111111111111111111
10000000001100000000000000001
10110000011100000030000410001
10010000000000000000000010001
10110000011100000000000010001
10000000001100000111211114001
11110111111111011100000010001
11110111111111011101010010101
11000000110101011100000010301
10003004000000001100000010221
10000000000000001101010010001
11000000110101011111000000N01
11110111111101011111011110001
11111111111111111111111111111