R 1460 1300

NO ./assets/images/face_north.xpm
SO ./assets/images/face_south.xpm
WE ./assets/images/face_west.xpm
EA ./assets/images/face_east.xpm

V ./assets/images/viseur.xpm


F ./assets/images/vitrail-3.xpm
C ./assets/images/ice.xpm

1111111111111111111111111
1000000000110000000000001
1000000000110000000000001
1000000000110000000000001
1000000000110000000000001
1000000000000000000000001
10000000000000111000000011
10000000000001   10000001
10000000000000111000000011
1000000000000000000000001
10000000000N0000000000001
1000000000000000000000001
1111111111111111111111111