R 1460 1300
1111111111111111
1002001100000001
1N00200010000001
1000000000000001
1000000020000001
1000000000011111
1000000010000001
1111111111111111
