R 320 200
1111111111111111
1000001100000001
1000000010000001
1000N00000000001
1000000000000001
1000000000011111
1000000010000001
1111111111111111
