R 2560 1350
1111111111111111
1002001100000001
1N00000010000001
1000000000000001
1000000000000001
1000000000011111
1000000010000001
1111111111111111