R 1900 1500
1111111111
1000000001
1010101001
1000000001
1010101001
1000000001
1010101001
1000000001
1010101001
1111111111