R 1400 1300
1111111111
1000S00001
1010101001
1000000001
1111311111
1000000001
1010101001
1000000001
1010101001
1111111111
