R 1460 1300

NO ./assets/images/face_north.xpm
SO ./assets/images/face_south.xpm
WE ./assets/images/face_west.xpm
EA ./assets/images/face_east.xpm

V ./assets/images/viseur.xpm


F ./assets/images/floor.xpm
C ./assets/images/ice.xpm

                       
                    11
                   1001
                  100001
                 10000001
                1000N00001
               100000000001
              10000000000001
             1000000000000001
            100000000000000001
           100000001110000000011111111111
          100000001   1000000000000000001
           100000001110000000011111111101
            100000000000000001        101
             1000000000000001         101
              10000000000001          101
               100000000001           101
                1000000001            101
                 10000001             101
                  100001              101
                   1001111111111111111101
                    100000000000000000001
                     11111111111111111111